0020x0020:Level One
####################
#..................#
#...###............#
#...#..............#
##..#..............#
#........#####.....#
#........#...#.....#
#...##.......#.....#
#...##.......#.....#
#........#...#.....#
#......#######.....#
#......#.....#.....#
#............#.....#
#......#.....#.....#
#......#.....#.....#
#......#.....#.....#
#......###..##.....#
#..................#
#..................#
####################